"Model name","EStructuralFeature count","EENum count","EClass count","EDataType count","EMFCompare matchCount","Diagnostic count"
"tl_PH.cfg","17","0","5","12","8","0"
"07b_Pebbles_in_the_Flood.cfg","2042","0","370","1672","1120","0"
"Tusklet.cfg","334","0","79","255","157","0"
"ca_ES.cfg","17","0","5","12","8","0"
"units_offmap_goto_recall.cfg","96","0","4","92","87","0"
"conditionals.cfg","137","0","5","132","125","0"
"unit-utils.cfg","621","0","172","449","196","0"
"Flanker.cfg","355","0","71","284","188","0"
"Javelineer.cfg","277","0","61","216","140","0"
"Mage_Great.cfg","451","0","104","347","202","0"
"21_The_Plan.cfg","767","0","169","598","370","0"
"ANL_help.cfg","470","0","97","373","237","0"
"zombie-utils.cfg","1401","0","289","1112","682","0"
"Tusker.cfg","539","0","128","411","249","0"
"Dark_Mage.cfg","637","0","135","502","331","0"
"01_Overture.cfg","861","0","167","694","462","0"
"Shadow_Lord.cfg","429","0","95","334","202","0"
"scenario-high_xp_attack.cfg","762","0","115","647","481","0"
"Necro_Dark_Sorcerer.cfg","192","0","43","149","101","0"
"is_IS.cfg","21","0","6","15","10","0"
"Triton.cfg","272","0","60","212","135","0"
"protect_unit.cfg","758","0","174","584","359","0"
"Shyde.cfg","467","0","99","368","239","0"
"09_Shan_Taum_the_Smug.cfg","913","0","185","728","470","0"
"Outlaw_Ruffian.cfg","207","0","42","165","113","0"
"03_Guarded_Castle.cfg","2950","0","614","2336","1482","0"
"aspects.cfg","777","0","17","760","729","0"
"goto.cfg","2305","0","516","1789","1105","0"
"03_Bandits.cfg","762","0","174","588","335","0"
"Naga_Warden.cfg","214","0","41","173","124","0"
"Mounted_General.cfg","373","0","75","298","203","0"
"2p_Ruphus_Isle.cfg","128","0","30","98","62","0"
"2_Closing_the_Gates.cfg","2556","0","536","2020","1248","0"
"Outlaw_Thief.cfg","712","0","172","540","293","0"
"repeating_button_default.cfg","410","0","97","313","156","0"
"lua.cfg","321","0","63","258","151","0"
"04_Descending_into_Darkness.cfg","3114","0","626","2488","1623","0"
"01_Breaking_the_Chains.cfg","1366","0","310","1056","606","0"
"wml_error.cfg","367","0","91","276","156","0"
"test_return.cfg","63","0","5","58","51","0"
"Spirit_Spectre.cfg","339","0","65","274","188","0"
"13_The_Dwarven_Doors.cfg","2114","0","459","1655","996","0"
"Eyestalk.cfg","374","0","79","295","201","0"
"08_Glory.cfg","3069","0","628","2441","1511","0"
"Random_Scenario_Desert.cfg","809","0","135","674","498","0"
"Malin_Keshar.cfg","2447","0","356","2091","1575","0"
"sp_options_configure.cfg","283","0","68","215","125","0"
"Rabbit.cfg","200","0","45","155","102","0"
"Tentacle.cfg","631","0","134","497","321","0"
"event-utils.cfg","76","0","20","56","34","0"
"8p_Mokena_Prairie.cfg","336","0","80","256","159","0"
"game_save.cfg","302","0","75","227","130","0"
"13_The_Return_of_Trouble.cfg","1161","0","229","932","617","0"
"statistics_dialog.cfg","1361","0","336","1025","570","0"
"character-definitions.cfg","166","0","35","131","91","0"
"Marshal.cfg","366","0","82","284","172","0"
"Warrioress.cfg","224","0","44","180","125","0"
"Villagers.cfg","602","0","136","466","283","0"
"Dunefolk.cfg","63","0","16","47","32","0"
"Boat.cfg","68","0","17","51","34","0"
"internal-generic.cfg","1405","0","360","1045","487","0"
"07b_Undead_Crossing.cfg","924","0","202","722","428","0"
"scenario-movethrough.cfg","640","0","151","489","280","0"
"08_Ur_Thorodor.cfg","1030","0","221","809","500","0"
"addons.cfg","2526","0","485","2041","1204","0"
"Loyalist_Iron_Mauler.cfg","172","0","38","134","87","0"
"Wesbench_Shroud_Walk.cfg","2338","0","479","1859","938","0"
"22_Epilogue.cfg","146","0","34","112","65","0"
"A1.cfg","0","0","0","0","0","0"
"chatbox.cfg","366","0","92","274","150","0"
"addon_uninstall_list.cfg","418","0","104","314","178","0"
"text_box_default.cfg","605","0","143","462","256","0"
"05a_Muff_Malal_Peninsula.cfg","717","0","155","562","343","0"
"Skele_Sacrifice.cfg","99","0","24","75","47","0"
"httt_utils.cfg","2692","0","598","2094","1228","0"
"14_Human_Alliance.cfg","2112","0","425","1687","1094","0"
"12a_Get_the_Gold.cfg","1966","0","387","1579","997","0"
"listbox_default.cfg","357","0","83","274","146","0"
"Ruler.cfg","343","0","69","274","182","0"
"debug_clock.cfg","1024","0","233","791","478","0"
"A3.cfg","0","0","0","0","0","0"
"Wolf_Great.cfg","494","0","85","409","295","0"
"progressive.cfg","0","0","0","0","0","0"
"06b_The_Long_March.cfg","3498","0","648","2850","1909","0"
"03_display.cfg","668","0","162","506","281","0"
"brushes.cfg","179","0","44","135","79","0"
"test_move_unit.cfg","801","0","25","776","729","0"
"generators.cfg","294","0","69","225","124","0"
"09_Descent_into_Darkness.cfg","12584","0","2759","9825","5894","0"
"Alien_Spire.cfg","295","0","60","235","156","0"
"ANL_auto_working.cfg","857","0","185","672","406","0"
"mp_change_control.cfg","525","0","131","394","215","0"
"game_save_overwrite.cfg","254","0","63","191","109","0"
"scenario-poisoning.cfg","354","0","88","266","159","0"
"Ambusher.cfg","373","0","77","296","197","0"
"sg_story.cfg","677","0","116","561","381","0"
"02_Tutorial_part_2.cfg","3642","0","766","2876","1790","0"
"09_Blood_is_Thicker_Than_Water.cfg","8290","0","1705","6585","4197","0"
"items.cfg","320","0","76","244","138","0"
"Mage_White.cfg","558","0","127","431","256","0"
"movetypes.cfg","190","0","44","146","75","0"
"13_Epilogue.cfg","282","0","62","220","130","0"
"Small_Mudcrawler.cfg","132","0","29","103","64","0"
"sr_RS@ijekavianlatin.cfg","19","0","5","14","10","0"
"unit_list.cfg","1115","0","277","838","480","0"
"bg_BG.cfg","21","0","6","15","10","0"
"08b_Ray_of_Hope.cfg","3517","0","706","2811","1834","0"
"Cave_Serpent.cfg","33","0","8","25","16","0"
"Runemaster.cfg","260","0","47","213","153","0"
"simple_find_path.cfg","785","0","140","645","410","0"
"Wesfolk_Outcast.cfg","708","0","163","545","318","0"
"final_battle.cfg","476","0","116","360","194","0"
"01_Tutorial_part_1.cfg","3246","0","658","2588","1633","0"
"6p_Hexcake.cfg","260","0","62","198","123","0"
"pt_PT.cfg","17","0","5","12","8","0"
"Hoplite.cfg","226","0","48","178","118","0"
"06_Forbidden_Forest.cfg","1005","0","218","787","487","0"
"07b_A_Small_Favor2.cfg","3417","0","709","2708","1652","0"
"goal.cfg","199","0","35","164","106","0"
"engine.cfg","77","0","18","59","34","0"
"Loyalist_Sergeant.cfg","340","0","75","265","163","0"
"Protector.cfg","384","0","79","305","202","0"
"01_The_Morning_After.cfg","3805","0","805","3000","1867","0"
"Berserker.cfg","451","0","77","374","270","0"
"unit_attack.cfg","686","0","171","515","286","0"
"terrain.cfg","174","0","41","133","90","0"
"3p_Morituri.cfg","151","0","35","116","74","0"
"Rogue_Mage.cfg","337","0","64","273","189","0"
"07b_Protecting_the_Master.cfg","2146","0","488","1658","1038","0"
"editor_edit_scenario.cfg","712","0","176","536","311","0"
"toggle_panel_wml_message.cfg","193","0","46","147","79","0"
"toggle_button_icon.cfg","414","0","106","308","148","0"
"06_Uncharted_Islands.cfg","880","0","184","696","440","0"
"06_Return_to_Parthyn.cfg","2785","0","591","2194","1345","0"
"4t_The_Jeweler.cfg","1125","0","251","874","527","0"
"2p_Tombs_of_Kesorak.cfg","728","0","114","614","449","0"
"A2.cfg","0","0","0","0","0","0"
"garak-abilities.cfg","30","0","8","22","14","0"
"01_The_Raid.cfg","1406","0","270","1136","750","0"
"lobby_main.cfg","1913","0","444","1469","867","0"
"07a_The_Crossing.cfg","1314","0","294","1020","600","0"
"tooltip_floating.cfg","265","0","36","229","183","15"
"test_max_menu_items.cfg","388","0","8","380","367","0"
"06_Following_the_Shadow.cfg","1733","0","385","1348","811","0"
"Peasant.cfg","331","0","70","261","173","0"
"12_A_Final_Spring.cfg","2803","0","531","2272","1539","0"
"subst.cfg","13","0","4","9","6","3"
"Explorer.cfg","290","0","62","228","150","0"
"Fighter.cfg","309","0","69","240","149","0"
"10_Cliffs_of_Thoria.cfg","1284","0","279","1005","616","0"
"05b_Compelled.cfg","481","0","108","373","225","0"
"Divine_Avatar.cfg","289","0","63","226","142","0"
"Apprentice_Necromancer.cfg","634","0","134","500","331","0"
"bigmap.cfg","2324","0","441","1883","1072","0"
"Ringcaster.cfg","321","0","72","249","159","0"
"Vanguard.cfg","377","0","77","300","198","0"
"Wesbench_Scroll.cfg","298","0","74","224","122","0"
"Elder.cfg","239","0","54","185","114","0"
"06_The_Grey_Woods.cfg","1397","0","312","1085","661","0"
"rebels-aoh.cfg","93","0","13","80","67","0"
"scenario_micro_ai.cfg","2468","0","503","1965","1263","0"
"18_The_Portal_of_Doom.cfg","1657","0","338","1319","841","0"
"synced_choice_wait.cfg","221","0","55","166","94","0"
"Fire_Guardian2.cfg","43","0","11","32","19","0"
"Assassin.cfg","343","0","75","268","166","0"
"test_require.cfg","31","0","4","27","22","0"
"4p_Morituri.cfg","188","0","44","144","91","0"
"5p_Auction-X.cfg","247","0","59","188","118","0"
"recruiting.cfg","418","0","93","325","209","0"
"Loyalist_Heavy_Infantryman.cfg","189","0","41","148","98","0"
"low-macros.cfg","562","0","125","437","255","0"
"23_Epilogue.cfg","84","0","20","64","38","0"
"Gryphon.cfg","222","0","51","171","105","0"
"Soldier.cfg","178","0","38","140","93","0"
"Woodsman.cfg","349","0","80","269","164","0"
"drawing_default.cfg","18","0","5","13","8","0"
"mp_join_game.cfg","1148","0","278","870","496","0"
"Bat_Blood.cfg","51","0","12","39","25","0"
"amlas.cfg","3006","0","753","2253","1275","0"
"21_Elvish_Assassins.cfg","1457","0","329","1128","691","0"
"2p_The_Walls_of_Pyrennis.cfg","364","0","57","307","223","0"
"24_Epilogue.cfg","166","0","38","128","71","0"
"08_Out_of_the_Frying_Pan.cfg","12886","0","2590","10296","6683","0"
"chat_log.cfg","478","0","117","361","206","0"
"Hero.cfg","394","0","65","329","253","0"
"06_advanced.cfg","353","0","89","264","143","0"
"ru_RU.cfg","21","0","6","15","10","0"
"17_Mortality.cfg","1033","0","243","790","465","0"
"Youth.cfg","23","0","6","17","11","3"
"12_Giving_Some_Back.cfg","775","0","169","606","356","0"
"Corpse_Soulless.cfg","1355","0","271","1084","707","0"
"Kraken.cfg","700","0","163","537","317","0"
"scenario-formula-recruitment.cfg","158","0","38","120","68","0"
"02_The_Escape_Tunnel.cfg","1479","0","329","1150","690","0"
"mp_unit_test_macros.cfg","170","0","42","128","71","0"
"test_relative_dir.cfg","455","0","44","411","335","0"
"07_Return_to_Oldwood.cfg","1328","0","241","1087","754","0"
"Ogre.cfg","190","0","44","146","89","0"
"Skirmisher.cfg","416","0","83","333","225","0"
"Glider.cfg","282","0","55","227","154","0"
"editor_set_starting_position.cfg","430","0","107","323","184","0"
"Wayfarer.cfg","293","0","63","230","150","0"
"Outlaw_Footpad.cfg","452","0","103","349","206","0"
"11_Battle_of_the_Book.cfg","1000","0","206","794","505","0"
"umc.cfg","20","0","5","15","9","0"
"button_25x25.cfg","844","0","170","674","387","0"
"Ethereal_Shadow.cfg","85","0","21","64","34","0"
"Loyalist_Master_Bowman.cfg","328","0","72","256","160","0"
"Naga_Guardian.cfg","214","0","41","173","124","0"
"Fire_Guardian3.cfg","51","0","13","38","23","0"
"02_01_Infested_Caves.cfg","3207","0","718","2489","1475","0"
"14_Back_Home.cfg","2681","0","520","2161","1438","0"
"drakes-default.cfg","74","0","13","61","48","0"
"unit_advance.cfg","500","0","125","375","209","0"
"Dwarvish_Masked_Thunderguard.cfg","524","0","112","412","260","0"
"Random_Scenario.cfg","1080","0","176","904","676","0"
"Dark_Shape.cfg","67","0","17","50","34","0"
"07a_A_Small_Favor.cfg","2986","0","594","2392","1500","0"
"scenario-test.cfg","1742","0","30","1712","1677","3"
"break_replay_with_lua_random.cfg","214","0","10","204","188","0"
"03_The_Road_to_Weldyn.cfg","695","0","145","550","348","0"
"stable_singleplayer.cfg","11","0","2","9","8","0"
"Dwarvish_Masked_Lord.cfg","372","0","81","291","184","0"
"Whelp.cfg","208","0","47","161","99","0"
"diff.cfg","210","0","51","159","87","0"
"dialog-macros.cfg","257","0","60","197","110","0"
"Pillager.cfg","505","0","99","406","273","0"
"2p_Hornshark_Island.cfg","2771","0","672","2099","1063","0"
"window_default.cfg","474","0","116","358","192","0"
"04_Spring_of_Reprisal.cfg","1548","0","319","1229","771","0"
"2p_Fallenstar_Lake.cfg","128","0","30","98","62","0"
"2p_Silverhead_Crossing.cfg","341","0","80","261","161","0"
"4p_Geothermal.cfg","210","0","50","160","99","0"
"Hurricane.cfg","366","0","76","290","187","0"
"Haldric_II.cfg","184","0","41","143","90","0"
"1_A_Bargain_is_Struck.cfg","2812","0","631","2181","1310","0"
"et_EE.cfg","17","0","5","12","8","0"
"12_Northern_Winter.cfg","1243","0","257","986","612","0"
"Outrider.cfg","367","0","70","297","205","0"
"01_At_the_East_Gate.cfg","586","0","131","455","273","0"
"0004-filtered_combat.cfg","253","0","52","201","135","0"
"formula_debugger.cfg","649","0","160","489","279","0"
"Rocklobber.cfg","427","0","84","343","233","0"
"panel_default.cfg","34","0","9","25","12","0"
"15_Civil_War.cfg","1209","0","251","958","603","0"
"animals.cfg","1514","0","294","1220","817","0"
"tree_view_default.cfg","177","0","43","134","69","0"
"07a_Return_to_Kerlath.cfg","1720","0","333","1387","894","0"
"Apprentice_Mage.cfg","402","0","89","313","198","0"
"Enforcer.cfg","570","0","93","477","353","0"
"Guardsman.cfg","368","0","82","286","176","0"
"04_Leollyn.cfg","879","0","195","684","406","0"
"Loyalist_Grand_Marshal.cfg","452","0","88","364","246","0"
"player_list_panel.cfg","209","0","53","156","86","0"
"Water_Serpent.cfg","485","0","100","385","277","0"
"07_Elensefar.cfg","557","0","118","439","268","0"
"2p_Ruined_Passage.cfg","136","0","32","104","66","0"
"for-loops.cfg","889","0","75","814","670","0"
"05b_Isle_of_the_Damned.cfg","1903","0","413","1490","885","0"
"2t_In_the_Dwarven_City.cfg","916","0","200","716","441","0"
"Journeyman_Mage.cfg","50","0","12","38","25","0"
"time-of-day.cfg","188","0","45","143","76","0"
"16_Dark_Sky_Over_Weldyn.cfg","758","0","124","634","452","0"
"wesnoth-manpages.cfg","165","0","18","147","126","21"
"sighted_events.cfg","402","0","85","317","191","0"
"themes.cfg","22","0","6","16","10","0"
"tr_TR.cfg","17","0","5","12","8","0"
"13_Together_Again.cfg","648","0","151","497","287","0"
"Mage.cfg","873","0","202","671","394","0"
"09_Foothills.cfg","1180","0","262","918","555","0"
"ai_test.cfg","110","0","17","93","77","3"
"Spearmaster.cfg","269","0","57","212","138","0"
"Naga_Hunter.cfg","339","0","67","272","184","0"
"02_Hostile_Mountains.cfg","1908","0","425","1483","873","0"
"mp_create_game.cfg","2375","0","508","1867","1178","0"
"sg_deaths.cfg","298","0","71","227","131","0"
"Outlaw_Thug.cfg","213","0","42","171","119","0"
"toggle_panel_default.cfg","476","0","67","409","309","0"
"2p_Sullas_Ruins.cfg","426","0","93","333","211","0"
"undead-aoh.cfg","64","0","13","51","38","0"
"Wyvern_Rider.cfg","241","0","52","189","124","0"
"ai_default_rca_alternate_recruiting.cfg","132","0","28","104","58","0"
"Flameheart.cfg","295","0","57","238","161","0"
"Fire.cfg","280","0","54","226","156","0"
"Outlaw_Rogue.cfg","411","0","91","320","195","0"
"test_lua.cfg","31","0","4","27","22","0"
"07b_Talking_with_Trolls.cfg","1788","0","406","1382","819","0"
"Nightblade.cfg","495","0","99","396","268","0"
"Ixthala_Demon.cfg","240","0","48","192","133","0"
"Spirit_Shadow.cfg","696","0","108","588","442","0"
"messenger_escort.cfg","701","0","147","554","352","0"
"02_Dark_Business.cfg","2867","0","603","2264","1400","0"
"Windbolt.cfg","288","0","61","227","151","0"
"pathfind_answers.cfg","33","0","9","24","17","0"
"campaign_difficulty.cfg","502","0","125","377","212","0"
"ar_AR.cfg","46","0","8","38","31","0"
"04_The_Elvish_Treasury.cfg","1255","0","276","979","589","9"
"sg_utils.cfg","53","0","11","42","33","3"
"filter_this_unit.cfg","249","0","11","238","219","0"
"Alien_Body.cfg","850","0","178","672","440","4"
"2p_Swamp_of_Dread.cfg","128","0","30","98","62","0"
"aspect_complex.cfg","892","0","188","704","404","0"
"Gorer.cfg","539","0","128","411","249","0"
"simple_attack.cfg","775","0","152","623","412","0"
"08_The_Princess_of_Wesnoth.cfg","1288","0","290","998","592","0"
"knalgans-default.cfg","61","0","12","49","37","0"
"10_Gryphon_Mountain.cfg","1770","0","366","1404","854","0"
"test_role_types.cfg","462","0","29","433","379","0"
"09_Xenophobia.cfg","1377","0","293","1084","671","0"
"game_save_message.cfg","342","0","85","257","147","0"
"castle-transitions.cfg","439","0","114","325","164","0"
"hotkey_bind.cfg","79","0","20","59","33","0"
"Leader.cfg","387","0","71","316","221","0"
"da_DK.cfg","17","0","5","12","8","0"
"bridge.cfg","2338","0","452","1886","1064","0"
"02_Civil_Disobedience.cfg","1242","0","243","999","646","0"
"button_default.cfg","1057","0","209","848","484","0"
"game_cache_options.cfg","543","0","133","410","235","0"
"Sleeping_Gryphon.cfg","141","0","32","109","71","0"
"2p_Clearing_Gushes.cfg","136","0","32","104","66","0"
"Undead_Horseman.cfg","239","0","55","184","113","0"
"Direwolf_Rider.cfg","436","0","85","351","235","0"
"Elder_Falcon.cfg","260","0","58","202","124","0"
"Troll.cfg","193","0","43","150","94","0"
"test_grunt_tod_damage.cfg","693","0","150","543","329","0"
"mp_connect.cfg","683","0","169","514","295","0"
"select_orb_colors.cfg","461","0","107","354","194","0"
"Dummy.cfg","70","0","18","52","35","0"
"01_End_of_Peace.cfg","862","0","188","674","414","0"
"simple_aspect.cfg","321","0","21","300","265","0"
"editor_new_map.cfg","391","0","97","294","170","0"
"18_Epilogue.cfg","832","0","184","648","396","0"
"Mage_Magister.cfg","113","0","26","87","53","0"
"2p_The_Freelands.cfg","128","0","30","98","62","0"
"map-utils.cfg","1318","0","293","1025","613","0"
"pbl.cfg","88","0","10","78","72","6"
"4p_Blue_Water_Province.cfg","192","0","44","148","95","0"
"11_Battle_for_Zocthanol_Isle.cfg","4182","0","888","3294","2064","0"
"06b_In_the_Domain_of_Dwarves.cfg","4984","0","1040","3944","2489","0"
"debug-utils.cfg","162","0","43","119","62","0"
"Wose_Shaman.cfg","362","0","78","284","189","0"
"idle.cfg","11","0","2","9","8","0"
"Hunter.cfg","385","0","84","301","192","0"
"18_Abandoned_Outpost.cfg","1396","0","320","1076","628","0"
"2p_Weldyn_Channel.cfg","128","0","30","98","62","0"
"Slayer.cfg","340","0","66","274","187","0"
"store_locations.cfg","124","0","11","113","94","0"
"deaths.cfg","311","0","75","236","137","0"
"Warrior.cfg","290","0","57","233","158","0"
"Mage_Silver.cfg","769","0","167","602","388","0"
"addon_manager.cfg","2515","0","615","1900","1092","0"
"14_Rough_Landing.cfg","1287","0","267","1020","667","0"
"_initial.cfg","2137","0","499","1638","975","3"
"22_Northern_Battle.cfg","1275","0","275","1000","612","0"
"gui.cfg","5879","0","1296","4583","2812","0"
"edit_label.cfg","343","0","85","258","147","0"
"generator_settings.cfg","526","0","114","412","253","0"
"09_Houses_of_the_Undead.cfg","1903","0","376","1527","989","0"
"leading_space.cfg","13","0","3","10","8","0"
"10a_Stolen_Gold.cfg","3679","0","781","2898","1778","0"
"Bat_Vampire.cfg","51","0","12","39","25","0"
"21_Clash_at_the_Manor.cfg","1474","0","307","1167","713","0"
"Necromancer.cfg","231","0","52","179","119","0"
"feeding.cfg","547","0","57","490","394","0"
"Skele_Draug.cfg","227","0","52","175","107","0"
"Dustbok.cfg","202","0","36","166","124","0"
"castles.cfg","381","0","96","285","144","0"
"Old_Orcish_Shaman.cfg","345","0","76","269","172","0"
"test_menu_items.cfg","76","0","9","67","52","0"
"journey_chapter1.cfg","298","0","54","244","146","0"
"traits.cfg","40","0","10","30","20","0"
"Lord.cfg","562","0","116","446","282","0"
"11_Wasteland.cfg","1104","0","238","866","522","0"
"Ranger.cfg","358","0","72","286","188","0"
"Gryphon_Rider.cfg","220","0","50","170","106","0"
"aspect_simple.cfg","272","0","57","215","113","0"
"17b_Weldyn_Besieged.cfg","2049","0","453","1596","951","0"
"repeating_button_scrollbar.cfg","421","0","94","327","184","0"
"20_Council_Ruling.cfg","301","0","65","236","147","0"
"journey_chapter3.cfg","1315","0","231","1084","635","0"
"dragon.cfg","437","0","97","340","213","0"
"09b_Bandit_Epilogue.cfg","106","0","25","81","52","0"
"15_Mountain_Pass.cfg","1124","0","254","870","504","0"
"Loyalist_Bowman.cfg","296","0","65","231","147","0"
"25_HttT_Epilogue.cfg","198","0","47","151","87","0"
"terrain-utils.cfg","188","0","47","141","72","0"
"0003-simple_combat.cfg","110","0","27","83","49","0"
"4p_Loris_River.cfg","188","0","44","144","91","0"
"Oracle.cfg","391","0","75","316","212","0"
"Mudcrawler.cfg","232","0","52","180","115","0"
"Priestess.cfg","353","0","77","276","173","0"
"patrols.cfg","974","0","216","758","472","0"
"names.cfg","254","0","57","197","142","0"
"11_Clash_of_Armies.cfg","3689","0","718","2971","1906","0"
"08_Silent_Forest.cfg","1210","0","269","941","563","0"
"05_multiplayer.cfg","1238","0","271","967","600","0"
"editor_generate_map.cfg","500","0","124","376","207","0"
"drop_down_list.cfg","350","0","83","267","160","0"
"lurkers.cfg","1779","0","306","1473","1049","0"
"Marksman.cfg","367","0","70","297","205","0"
"formula.cfg","53","0","11","42","27","12"
"18_Hour_of_Glory.cfg","411","0","72","339","241","0"
"toggle_button_radio.cfg","376","0","87","289","143","0"
"09a_Introductions.cfg","1331","0","287","1044","633","0"
"Spider_Lich.cfg","478","0","102","376","244","0"
"Clasher.cfg","512","0","85","427","311","0"
"04_Return_to_the_Village.cfg","1116","0","243","873","537","0"
"2p_Thousand_Stings_Garrison.cfg","960","0","140","820","596","0"
"03_An_Unexpected_Appearance.cfg","825","0","169","656","416","0"
"Woodsman_Ranger.cfg","372","0","82","290","184","0"
"gl_ES.cfg","17","0","5","12","8","0"
"horizontal_scrollbar_default.cfg","309","0","69","240","136","0"
"abilities.cfg","55","0","14","41","26","0"
"side.cfg","112","0","20","92","60","0"
"dunefolk-aoh.cfg","91","0","13","78","65","0"
"scroll_label_default.cfg","244","0","58","186","96","0"
"Horseman.cfg","325","0","70","255","159","0"
"07_Crossroads.cfg","1642","0","340","1302","813","0"
"scenario-lua_ai_old_syntax.cfg","336","0","81","255","156","0"
"graphics.cfg","266","0","50","216","130","0"
"macros.cfg","256","0","40","216","154","0"
"King_of_Wesnoth.cfg","59","0","14","45","28","0"
"19_Lava_and_Stone.cfg","536","0","115","421","259","0"
"05_To_the_Harbor_of_Tirigaz.cfg","986","0","224","762","443","0"
"Battle_Princess.cfg","886","0","171","715","472","0"
"15_The_Treaty.cfg","480","0","87","393","276","0"
"wov-macros.cfg","108","0","26","82","48","0"
"gates.cfg","941","0","202","739","453","0"
"Corpse_Walking.cfg","1352","0","270","1082","707","0"
"pt_BR.cfg","17","0","5","12","8","0"
"13a_Showdown.cfg","4126","0","851","3275","1998","0"
"Sun_Singer.cfg","464","0","94","370","252","0"
"Necro_Ancient_Lich.cfg","579","0","124","455","295","0"
"test_dofile.cfg","74","0","11","63","44","0"
"03_The_Isle_of_Alduin.cfg","1088","0","246","842","498","0"
"Loyalist_Cavalier.cfg","342","0","77","265","165","0"
"02_Flight.cfg","2748","0","597","2151","1286","0"
"Dark_Queen.cfg","386","0","82","304","201","0"
"test_cve_2018_1999023.cfg","61","0","13","48","29","0"
"racv.cfg","17","0","5","12","8","0"
"Woodsman_Trapper.cfg","389","0","85","304","189","0"
"03_A_Harrowing_Escape.cfg","1497","0","286","1211","811","0"
"attack_predictions.cfg","824","0","188","636","363","0"
"minimap_default.cfg","95","0","24","71","37","0"
"walls.cfg","2260","0","415","1845","1066","0"
"Horse_Archer.cfg","278","0","58","220","149","0"
"04a_An_Elven_Alliance.cfg","1064","0","236","828","502","0"
"Sailor.cfg","128","0","29","99","66","0"
"Cave_Spider.cfg","54","0","13","41","26","0"
"06_Temple_in_the_Deep.cfg","1234","0","236","998","651","0"
"04b_The_Undead_Border_Patrol.cfg","797","0","177","620","369","0"
"Skeleton_Rider.cfg","248","0","57","191","116","0"
"11_Getting_Help.cfg","600","0","137","463","281","0"
"title_screen.cfg","1032","0","237","795","448","0"
"builder.cfg","256","0","51","205","119","30"
"Wolf_Rider.cfg","411","0","69","342","250","0"
"01_A_Summer_of_Storms.cfg","1079","0","220","859","561","0"
"15_The_Council.cfg","589","0","132","457","284","0"
"test_movetype.cfg","1360","0","264","1096","689","0"
"journey_chapter2.cfg","466","0","84","382","224","0"
"Jinn.cfg","184","0","41","143","90","0"
"music.cfg","10","0","3","7","4","0"
"_main.cfg","60","0","14","46","27","0"
"scroll_label_verbatim.cfg","236","0","58","178","93","0"
"wesnoth-wml-additions.cfg","65","0","18","47","19","0"
"Noble_Fighter.cfg","190","0","42","148","95","0"
"12_The_Final_Confrontation.cfg","3817","0","825","2992","1814","0"
"Dwarvish_Masked_Steelclad.cfg","292","0","63","229","148","0"
"Frontier_Baroness.cfg","403","0","92","311","187","0"
"0001-healing.cfg","327","0","63","264","175","0"
"Zephyr.cfg","324","0","73","251","159","0"
"listbox_wml_message.cfg","249","0","61","188","96","0"
"06_The_Three_Sisters.cfg","1075","0","222","853","515","0"
"internal-border.cfg","1079","0","258","821","452","0"
"5p_Forest_of_Fear.cfg","223","0","53","170","106","0"
"tiny_resolution.cfg","840","0","209","631","325","0"
"sl_SI.cfg","17","0","5","12","8","0"
"Sunderer.cfg","289","0","61","228","153","0"
"Dwarvish_Masked_Dragonguard.cfg","509","0","111","398","247","0"
"Divine_Incarnation.cfg","74","0","18","56","34","0"
"facing.cfg","217","0","25","192","151","0"
"4p_Bath_of_Glory.cfg","250","0","60","190","117","0"
"Giant_Scorpling.cfg","333","0","68","265","179","0"
"Dwarvish_Rune_Lord.cfg","834","0","151","683","512","0"
"test_berzerk_firststrike.cfg","174","0","13","161","139","0"
"SotA_Soulless.cfg","1447","0","288","1159","746","0"
"game_stats.cfg","1986","0","485","1501","848","0"
"Loyalist_Javelineer.cfg","337","0","77","260","157","0"
"Delinquent.cfg","294","0","65","229","147","0"
"Loyalist_Spearman.cfg","558","0","125","433","260","0"
"trow-macros.cfg","342","0","92","250","116","0"
"loyalists-default.cfg","63","0","13","50","37","0"
"actionwml.cfg","7225","0","1375","5850","3468","0"
"04c_Mal-Ravanals_Capital.cfg","1859","0","388","1471","951","0"
"intro.cfg","207","0","40","167","113","0"
"side-utils.cfg","628","0","149","479","242","0"
"ai_controller.cfg","3610","0","693","2917","1820","0"
"19c_Cliffs_of_Thoria.cfg","3262","0","666","2596","1639","0"
"14_Approaching_Weldyn.cfg","833","0","181","652","394","0"
"Death_Squire.cfg","224","0","51","173","104","0"
"03_Strange_Allies.cfg","881","0","193","688","420","0"
"outro.cfg","156","0","40","116","62","0"
"02_The_Chase.cfg","1885","0","401","1484","934","0"
"mp_login.cfg","553","0","137","416","237","0"
"undead-default.cfg","64","0","13","51","38","0"
"02_Peaceful_Valley.cfg","1571","0","323","1248","778","0"
"Random_Scenario_Winter.cfg","977","0","161","816","609","0"
"menu_button_default.cfg","504","0","113","391","221","0"
"Wose_Sapling.cfg","218","0","49","169","105","0"
"Noble.cfg","67","0","17","50","34","0"
"mp_host_game_prompt.cfg","287","0","71","216","125","0"
"4p_Paths_of_Daggers.cfg","188","0","44","144","91","0"
"Dirkfang.cfg","308","0","68","240","157","0"
"Sovereign.cfg","390","0","72","318","221","0"
"heal.cfg","556","0","50","506","426","0"
"Burner.cfg","287","0","56","231","158","0"
"animations.cfg","948","0","198","750","508","0"
"characters.cfg","371","0","84","287","168","0"
"Dwarvish_Miner.cfg","225","0","39","186","140","0"
"test_for_tag.cfg","334","0","31","303","244","0"
"Corpse_Shynal.cfg","298","0","70","228","136","0"
"4p_Xanthe_Chaos.cfg","186","0","44","142","89","0"
"filter_vision.cfg","603","0","94","509","370","0"
"test1.cfg","90","0","2","88","87","0"
"2p_Caves_of_the_Basilisk.cfg","600","0","127","473","298","0"
"internal-corners.cfg","180","0","46","134","70","0"
"19_Epilogue.cfg","209","0","48","161","90","0"
"02_Proven_by_the_Sword.cfg","2741","0","573","2168","1360","0"
"06_The_Siege_of_Elensefar.cfg","646","0","133","513","327","9"
"Human_Commander.cfg","343","0","68","275","185","0"
"04_Slavers.cfg","2483","0","521","1962","1227","0"
"test_check_victory.cfg","752","0","132","620","406","0"
"simple_item_selector.cfg","368","0","92","276","155","0"
"Dwarvish_Witness.cfg","387","0","78","309","212","0"
"07_The_Siege_of_Kal_Kartha.cfg","1192","0","252","940","598","0"
"Ant.cfg","175","0","36","139","96","0"
"sr_RS@latin.cfg","19","0","5","14","10","0"
"06a_Old_Friend.cfg","1754","0","353","1401","877","0"
"Giant_Mudcrawler.cfg","322","0","63","259","181","0"
"23_End_of_War.cfg","689","0","151","538","328","0"
"Horse_Paladin.cfg","386","0","87","299","181","0"
"4p_A_New_Land.cfg","2935","0","635","2300","1431","0"
"ANL_leader_options.cfg","1867","0","391","1476","905","18"
"terrain-graphics.cfg","9726","0","569","9157","8023","0"
"05a_01_The_Pursuit.cfg","7192","0","1388","5804","3782","18"
"animation_macros.cfg","259","0","45","214","130","0"
"modify.cfg","187","0","47","140","66","6"
"Captain.cfg","205","0","45","160","101","0"
"aquatic.cfg","1529","0","329","1200","722","0"
"unit.cfg","299","0","53","246","151","0"
"Sorceress.cfg","500","0","95","405","285","0"
"Runesmith.cfg","275","0","52","223","157","0"
"ai_experimental.cfg","249","0","61","188","108","0"
"specials.cfg","39","0","10","29","19","0"
"editor.cfg","3337","0","773","2564","1671","0"
"05_Islands.cfg","1105","0","225","880","566","0"
"03_Wolf_Coast.cfg","1151","0","261","890","527","0"
"Ulfserker.cfg","440","0","74","366","267","0"
"6p_Waterloo_Sunset.cfg","284","0","68","216","135","0"
"two_plus_two.cfg","85","0","11","74","55","0"
"Shaman.cfg","464","0","98","366","239","0"
"Random_Scenario_Marsh.cfg","922","0","152","770","572","0"
"hu_HU.cfg","17","0","5","12","8","0"
"test_event_names_and_order.cfg","201","0","14","187","162","0"
"10_The_Gate_Between_Worlds.cfg","851","0","169","682","441","0"
"07_Night_in_the_Swamp.cfg","663","0","151","512","286","0"
"trow-deaths.cfg","375","0","84","291","175","0"
"carryover-utils.cfg","16","0","5","11","7","0"
"19b_Swamp_Of_Dread.cfg","1414","0","311","1103","660","0"
"Warden.cfg","607","0","121","486","321","0"
"test_cve_2018_1999023_2.cfg","30","0","3","27","24","0"
"10_Saving_Inarix.cfg","2329","0","490","1839","1135","0"
"09b_Judgment.cfg","497","0","110","387","246","0"
"Sea_Captain.cfg","141","0","32","109","70","0"
"Mage_of_Light.cfg","537","0","121","416","249","0"
"6p_Volcano.cfg","388","0","73","315","221","0"
"dw-utils.cfg","417","0","101","316","175","0"
"Royal_Warrior.cfg","191","0","42","149","96","0"
"Skele_Banebow.cfg","341","0","74","267","169","0"
"scenario-AI_Arena_small.cfg","937","0","211","726","433","0"
"sota-utils.cfg","3052","0","693","2359","1382","0"
"mp_join_game_password_prompt.cfg","335","0","83","252","144","0"
"16_The_Coward.cfg","1061","0","206","855","576","0"
"vertical_scrollbar_default.cfg","309","0","69","240","136","0"
"Shadow_Mage.cfg","352","0","75","277","179","0"
"3p_Island_of_the_Horatii.cfg","151","0","35","116","74","0"
"11_Captured.cfg","3861","0","781","3080","1922","0"
"game_delete.cfg","283","0","70","213","123","0"
"06_Black_Flag.cfg","1274","0","270","1004","641","0"
"08_Wesmere.cfg","989","0","213","776","480","0"
"Swordsman.cfg","225","0","49","176","114","0"
"13_Peoples_in_Decline.cfg","1102","0","230","872","563","0"
"05_Council_in_Weldyn.cfg","536","0","106","430","281","0"
"special-notes.cfg","936","0","220","716","405","3"
"08a_Elvish_Princess.cfg","1665","0","315","1350","841","0"
"characterize_pathfinding.cfg","3040","0","494","2546","1629","9"
"Necro_Lich.cfg","37","0","9","28","19","0"
"pango.cfg","185","0","47","138","70","0"
"18_A_Spy_in_the_Woods.cfg","580","0","118","462","303","0"
"The_Elves_Besieged.cfg","1000","0","222","778","482","0"
"Thunderer.cfg","679","0","142","537","335","0"
"test2.cfg","90","0","2","88","87","0"
"test_victory_attacks.cfg","732","0","80","652","526","0"
"Brawler.cfg","541","0","121","420","256","0"
"Mage_Arch.cfg","520","0","121","399","228","0"
"scenario-leaders.cfg","148","0","37","111","69","0"
"teleport-utils.cfg","825","0","161","664","462","0"
"Orcish_Shaman.cfg","344","0","76","268","171","0"
"config.cfg","1130","0","214","916","540","0"
"Novice_Orcish_Shaman.cfg","345","0","76","269","172","0"
"Noble_Youth.cfg","174","0","38","136","89","0"
"Rover.cfg","282","0","60","222","147","0"
"Harrier.cfg","355","0","79","276","171","0"
"Gryphon_Master.cfg","223","0","51","172","106","0"
"4p_Ruins_of_Terra-Dwelve.cfg","204","0","48","156","99","0"
"Knight.cfg","291","0","52","239","173","0"
"01_The_Elves_Besieged.cfg","1851","0","416","1435","855","0"
"base_value.cfg","49","0","10","39","24","0"
"Horse_Lord.cfg","291","0","63","228","145","0"
"terrain_layers.cfg","1040","0","258","782","447","0"
"17_The_Human_Attack.cfg","1751","0","366","1385","881","0"
"01_Born_to_the_Banner.cfg","2346","0","523","1823","1086","0"
"Mage_Commander.cfg","110","0","25","85","53","0"
"weapon.cfg","108","0","20","88","53","0"
"02_This_Valley_Belongs_to_Me.cfg","536","0","119","417","244","0"
"Lady.cfg","81","0","20","61","41","0"
"Druid.cfg","464","0","98","366","239","0"
"Wolf.cfg","376","0","64","312","229","0"
"animation-utils.cfg","4680","0","872","3808","2694","0"
"15_Save_the_King.cfg","1514","0","302","1212","789","0"
"2p_Cynsaun_Battlefield.cfg","152","0","36","116","73","0"
"panel_box_display.cfg","299","0","59","240","155","0"
"northerners-default.cfg","62","0","12","50","38","0"
"mr_IN.cfg","21","0","6","15","10","0"
"ca_ES@valencia.cfg","19","0","5","14","10","0"
"scenario-formula.cfg","658","0","158","500","303","0"
"09_Epilogue.cfg","243","0","53","190","120","0"
"Spectral_Servant.cfg","1742","0","294","1448","1035","0"
"Lynx.cfg","212","0","49","163","105","0"
"about_i18n.cfg","0","0","0","0","0","0"
"dev_singleplayer.cfg","11","0","2","9","8","0"
"cores.cfg","36","0","8","28","21","0"
"la_IT.cfg","17","0","5","12","8","0"
"07_The_Hunters.cfg","1136","0","245","891","540","0"
"has_ally.cfg","386","0","51","335","271","0"
"sg_help.cfg","383","0","93","290","154","0"
"stacked_widget_default.cfg","70","0","18","52","30","0"
"keep.cfg","6552","0","1177","5375","3200","0"
"Skeleton_Archer.cfg","438","0","98","340","206","0"
"08_The_Court_of_Karrag.cfg","1017","0","216","801","494","0"
"Netcaster.cfg","347","0","76","271","173","0"
"Giant_Scorpion.cfg","811","0","151","660","455","0"
"times.cfg","30","0","7","23","14","0"
"healer_support.cfg","311","0","71","240","155","0"
"6p_Team_Survival.cfg","2903","0","404","2499","1854","0"
"sr_RS@ijekavian.cfg","23","0","6","17","12","0"
"07_Elves_Last_Stand.cfg","2030","0","425","1605","1013","0"
"11_Battleground.cfg","772","0","163","609","384","0"
"Armageddon.cfg","301","0","60","241","163","0"
"Young_Ogre.cfg","187","0","43","144","89","0"
"Loyalist_Longbowman.cfg","318","0","71","247","153","0"
"8p_Morituri.cfg","344","0","80","264","167","0"
"11_The_Ford_of_Abez.cfg","1731","0","376","1355","811","0"
"Troll_Shaman.cfg","578","0","109","469","348","0"
"11_Fire_Meets_Steel.cfg","750","0","161","589","361","0"
"sides.cfg","1535","0","332","1203","710","0"
"ANL_general_macros.cfg","240","0","66","174","81","0"
"Spearguard.cfg","266","0","56","210","138","0"
"5_Hills_of_the_Shorbear_Clan.cfg","2435","0","558","1877","1075","0"
"Dwarvish_Masked_Fighter.cfg","297","0","58","239","162","0"
"Wesfolk_Leader.cfg","711","0","164","547","318","0"
"progress_bar.cfg","14","0","3","11","8","3"
"conditional-utils.cfg","201","0","52","149","68","6"
"Strider.cfg","352","0","78","274","171","0"
"05_Tirigaz.cfg","2509","0","577","1932","1120","0"
"01_Saving_Parthyn.cfg","1882","0","408","1474","902","0"
"ai_default_rca.cfg","93","0","22","71","37","0"
"Impaler.cfg","637","0","122","515","358","0"
"loyalists-aoh.cfg","73","0","13","60","47","0"
"editor_edit_label.cfg","748","0","185","563","327","0"
"06_Acquaintance_in_Need.cfg","1197","0","247","950","601","0"
"amla.cfg","83","0","21","62","38","0"
"recruitment.cfg","91","0","19","72","43","0"
"editor_resize_map.cfg","835","0","207","628","355","0"
"Skele_Revenant.cfg","268","0","56","212","139","0"
"Arcanister.cfg","284","0","52","232","166","0"
"toggle_button_tree_view_node.cfg","146","0","37","109","52","0"
"end_credits.cfg","324","0","81","243","133","0"
"21_Elven_Council.cfg","1018","0","231","787","481","0"
"2p_Sablestone_Delta.cfg","116","0","27","89","57","0"
"Sun_Sylph.cfg","617","0","132","485","305","0"
"Outlaw_Highwayman.cfg","187","0","37","150","105","0"
"04_Becalmed.cfg","2009","0","439","1570","942","0"
"Mage_Leader.cfg","102","0","23","79","51","0"
"null.cfg","26","0","7","19","12","0"
"07_Bilheld.cfg","593","0","116","477","311","0"
"storytxt.cfg","532","0","125","407","222","0"
"event_handlers_in_events.cfg","864","0","54","810","705","0"
"Mounted_Warrior.cfg","288","0","62","226","145","0"
"Ethereal_Nightgaunt.cfg","81","0","20","61","32","0"
"uk_UA.cfg","21","0","6","15","10","0"
"Horse_Lancer.cfg","231","0","50","181","114","0"
"Thunderguard.cfg","615","0","125","490","314","0"
"05_Fear.cfg","2046","0","461","1585","925","0"
"Bone_Knight.cfg","307","0","68","239","150","0"
"Roc.cfg","262","0","59","203","125","0"
"addon_connect.cfg","432","0","107","325","185","0"
"Grunt.cfg","323","0","59","264","186","0"
"9p_Merkwuerdigliebe.cfg","375","0","90","285","176","0"
"Diviner.cfg","364","0","79","285","178","0"
"Flesh_Golem.cfg","291","0","62","229","149","0"
"Mal_Keshar.cfg","1758","0","323","1435","983","0"
"Dervish.cfg","330","0","74","256","163","0"
"Myrmidon.cfg","245","0","47","198","140","0"
"depcheck_select_new.cfg","358","0","89","269","152","0"
"Princess.cfg","585","0","119","466","303","0"
"ANL_objectives.cfg","134","0","33","101","60","0"
"Warrior_King.cfg","144","0","33","111","72","0"
"language_selection.cfg","350","0","87","263","148","0"
"Ghast.cfg","63","0","16","47","24","0"
"folder_create.cfg","294","0","73","221","126","0"
"Spirit_Nightgaunt.cfg","230","0","51","179","109","0"
"03_A_Desparate_Errand.cfg","1865","0","398","1467","916","0"
"zh_CN.cfg","21","0","6","15","10","0"
"Loyalist_Shock_Trooper.cfg","169","0","37","132","87","0"
"Vampire_Lady.cfg","348","0","70","278","187","0"
"10_Merfolk_Revenge.cfg","1486","0","336","1150","676","0"
"help.cfg","17","0","5","12","8","0"
"20_Return_of_the_Fleet.cfg","2103","0","403","1700","1147","0"
"hr_HR.cfg","17","0","5","12","8","0"
"Augur.cfg","397","0","76","321","216","0"
"custom_tod.cfg","1105","0","266","839","485","0"
"8_The_Dragon.cfg","1598","0","337","1261","777","0"
"fi_FI.cfg","17","0","5","12","8","0"
"herodeaths.cfg","163","0","41","122","67","0"
"Kalian.cfg","24","0","6","18","12","0"
"lv_LV.cfg","17","0","5","12","8","0"
"Commander.cfg","507","0","105","402","255","0"
"xp_mod.cfg","157","0","10","147","130","0"
"10_Sewer_of_Southbay.cfg","1469","0","268","1201","817","0"
"Archer.cfg","352","0","66","286","202","0"
"Fighteress.cfg","220","0","43","177","124","0"
"fonts.cfg","107","0","26","81","51","0"
"mp_faction_select.cfg","940","0","227","713","405","0"
"order_of_nested_events.cfg","60","0","6","54","45","0"
"17a_The_Dragon.cfg","1837","0","386","1451","904","0"
"size_lock_default.cfg","22","0","6","16","9","0"
"19a_Snow_Plains.cfg","631","0","139","492","302","0"
"09_The_Mage.cfg","1453","0","328","1125","657","0"
"10_The_Flaming_Sword.cfg","3294","0","707","2587","1564","0"
"Marauder.cfg","298","0","64","234","154","0"
"window_borderless.cfg","199","0","50","149","76","0"
"file_dialog.cfg","972","0","241","731","412","0"
"Noble_Commander.cfg","343","0","73","270","172","0"
"lists.cfg","89","0","23","66","31","0"
"geography.cfg","296","0","66","230","150","0"
"04b_The_Midlands.cfg","1453","0","292","1161","766","0"
"mountains.cfg","1884","0","464","1420","734","0"
"Bone_Bird.cfg","124","0","31","93","56","0"
"07_The_Desert_of_Death.cfg","1404","0","314","1090","646","0"
"Naga_Sentinel.cfg","217","0","42","175","124","0"
"unit_recruit.cfg","620","0","155","465","257","0"
"scenario-lua_ai.cfg","259","0","62","197","121","0"
"sound-utils.cfg","1952","0","427","1525","965","120"
"4_Gathering_Materials.cfg","3284","0","699","2585","1606","0"
"Sky.cfg","363","0","75","288","187","0"
"Outlaw_Assassin.cfg","535","0","120","415","243","0"
"Wesfolk_Lady.cfg","708","0","163","545","318","0"
"10_Endless_Night.cfg","5374","0","1165","4209","2573","0"
"05_Hide_and_Seek.cfg","1825","0","397","1428","884","0"
"races.cfg","108","0","20","88","53","0"
"edit_text.cfg","288","0","72","216","122","0"
"eu_ES.cfg","17","0","5","12","8","0"
"Dwarvish_Masked_Ulfserker.cfg","381","0","61","320","240","0"
"id_ID.cfg","17","0","5","12","8","0"
"Ophidian.cfg","327","0","73","254","163","0"
"2p_Arcanclave_Citadel.cfg","148","0","35","113","71","0"
"02_02_Meeting_With_Dwarves.cfg","546","0","117","429","266","0"
"20_Prince_of_Wesnoth.cfg","814","0","179","635","381","0"
"18_Northern_Alliance.cfg","2748","0","562","2186","1397","0"
"Galleon.cfg","68","0","17","51","34","0"
"03_A_Haunting_in_Winter.cfg","5912","0","1280","4632","2813","0"
"test_assert.cfg","133","0","10","123","106","0"
"Young_King.cfg","130","0","29","101","68","0"
"18_A_Choice_Must_Be_Made.cfg","1410","0","320","1090","647","0"
"story_viewer.cfg","442","0","111","331","176","0"
"en_US.cfg","18","0","5","13","9","0"
"14a_Epilogue.cfg","1430","0","324","1106","660","0"
"sv_SE.cfg","17","0","5","12","8","0"
"01_The_Outpost.cfg","1437","0","325","1112","653","0"
"Alchemist.cfg","303","0","66","237","150","0"
"default_resolution.cfg","944","0","235","709","371","0"
"Loyalist_Swordsman.cfg","219","0","50","169","104","0"
"animation-utils2.cfg","970","0","217","753","480","0"
"throneroom.cfg","118","0","20","98","67","0"
"Corpse_Ghoul.cfg","218","0","48","170","107","0"
"22_The_Rise_of_Wesnoth.cfg","4831","0","1006","3825","2412","0"
"en@shaw.cfg","74","0","7","67","61","0"
"empty_test.cfg","8","0","2","6","5","0"
"Yeti.cfg","256","0","50","206","145","0"
"Cuttle_Fish.cfg","283","0","64","219","134","0"
"Wolf_Dire.cfg","331","0","63","268","186","0"
"19_Showdown_in_the_Northern_Swamp.cfg","1694","0","361","1333","822","0"
"09_The_Valley_of_Death.cfg","1515","0","337","1178","717","0"
"08_Training_the_Ogres.cfg","1063","0","221","842","516","0"
"Necro_Sacrifice.cfg","67","0","17","50","34","0"
"05_The_Saurian_Treasury.cfg","1681","0","365","1316","791","0"
"Transport_Galleon.cfg","138","0","33","105","68","0"
"tips.cfg","973","0","210","763","486","0"
"addon_list.cfg","1337","0","331","1006","565","0"
"trow-nlmsg.cfg","331","0","76","255","146","0"
"scroll_label_wml_message.cfg","197","0","48","149","76","0"
"6_Towards_the_Caves.cfg","1946","0","447","1499","854","0"
"04_Vale_of_Tears.cfg","2185","0","492","1693","1016","0"
"hang_out.cfg","521","0","119","402","251","0"
"new-macros.cfg","13914","0","3190","10724","6103","9"
"16_Hasty_Alliance.cfg","1333","0","293","1040","634","0"
"Dwarvish_Masked_Thunderer.cfg","532","0","115","417","260","0"
"label_settings.cfg","317","0","79","238","131","0"
"17_Scepter_of_Fire.cfg","2436","0","515","1921","1192","0"
"Wesbench_AI.cfg","420","0","101","319","197","0"
"01_Slipping_Away.cfg","1173","0","256","917","527","0"
"2p_Den_of_Onis.cfg","161","0","33","128","86","0"
"4p_King_of_the_Hill.cfg","204","0","48","156","99","0"
"schedule.cfg","126","0","30","96","46","0"
"base.cfg","7080","0","1273","5807","3456","0"
"09_Training_Session.cfg","1231","0","283","948","531","0"
"schedules.cfg","126","0","35","91","46","0"
"Crab_Man.cfg","193","0","40","153","108","0"
"Corpse_Necrophage.cfg","204","0","46","158","97","0"
"wml_unit_test_macros.cfg","282","0","65","217","122","0"
"01_general.cfg","624","0","143","481","282","0"
"SotA_Corpses.cfg","1606","0","314","1292","852","0"
"22_Face_of_the_Enemy.cfg","770","0","168","602","365","0"
"Skele_Bone_Shooter.cfg","354","0","77","277","175","0"
"Woodsman_Huntsman.cfg","352","0","77","275","172","0"
"Soothsayer.cfg","399","0","77","322","215","0"
"Steelclad.cfg","496","0","87","409","289","0"
"2p_Howling_Ghost_Badlands.cfg","293","0","45","248","182","0"
"05_A_Subterranean_Struggle.cfg","7361","0","1480","5881","3795","0"
"slider_minimal.cfg","275","0","64","211","116","0"
"lobby_player_info.cfg","751","0","185","566","313","0"
"Skele_Deathblade.cfg","267","0","62","205","122","0"
"Stalwart.cfg","381","0","78","303","202","0"
"Dwarvish_Masked_Stalwart.cfg","349","0","78","271","169","0"
"swarm.cfg","653","0","135","518","338","0"
"image_default.cfg","167","0","30","137","95","0"
"09_The_Underlevels.cfg","4074","0","889","3185","1891","0"
"Avenger.cfg","504","0","113","391","234","0"
"10_Speaking_with_the_Fishes.cfg","1935","0","381","1554","1038","0"
"knalgans-aoh.cfg","66","0","12","54","42","0"
"window_tooltip_large.cfg","256","0","65","191","108","0"
"Flagbearer.cfg","380","0","78","302","198","0"
"Spearman.cfg","282","0","62","220","143","0"
"internal-tracks.cfg","3543","0","841","2702","1458","0"
"drakes-aoh.cfg","83","0","13","70","57","0"
"03_Stirring_in_the_Night.cfg","6218","0","1314","4904","2984","0"
"dunefolk-default.cfg","75","0","13","62","49","0"
"ang_GB@latin.cfg","19","0","5","14","10","0"
"Champion.cfg","293","0","58","235","158","0"
"2p_Dark_Forecast.cfg","778","0","175","603","379","0"
"location.cfg","164","0","29","135","85","0"
"20b_Underground_Channels.cfg","1969","0","439","1530","907","0"
"zh_TW.cfg","21","0","6","15","10","0"
"lt_LT.cfg","17","0","5","12","8","0"
"2p_Aethermaw.cfg","2086","0","339","1747","1154","0"
"17b_Lizard_Beach.cfg","949","0","184","765","509","0"
"17_A_New_Ally.cfg","792","0","177","615","367","0"
"06a_In_the_Tunnels_of_Trolls.cfg","5019","0","1043","3976","2514","0"
"07a_Dealing_with_Dwarves.cfg","1770","0","411","1359","791","0"
"mp_alerts_options.cfg","682","0","157","525","311","0"
"interrupts.cfg","351","0","35","316","255","0"
"02_The_Fall.cfg","1623","0","337","1286","814","0"
"terrain-groups.cfg","313","0","75","238","150","0"
"terrain_graphics.cfg","249","0","36","213","161","0"
"label_story_screen_title.cfg","239","0","56","183","113","0"
"01_Rooting_Out_a_Mage.cfg","1097","0","224","873","553","0"
"Rider.cfg","446","0","89","357","236","0"
"Warlord.cfg","334","0","68","266","177","0"
"17d_Cursed_Isle.cfg","1603","0","343","1260","761","0"
"4p_Siege_Castles.cfg","204","0","48","156","99","0"
"16_The_Chief_Must_Die.cfg","3049","0","602","2447","1675","0"
"05_Northern_Outpost.cfg","1327","0","287","1040","631","0"
"10_Lake_Vrug.cfg","1256","0","284","972","580","0"
"conditionalwml.cfg","226","0","44","182","108","0"
"03_A_Strategy_Of_Hope.cfg","945","0","200","745","473","0"
"test_unit_map.cfg","473","0","33","440","379","0"
"mk_MK.cfg","21","0","6","15","10","0"
"Fog_Clearer.cfg","85","0","20","65","43","0"
"game_config.cfg","407","0","89","318","223","0"
"trow-abilities.cfg","47","0","12","35","22","0"
"Skele_Chocobone.cfg","254","0","61","193","111","0"
"Warmaster.cfg","208","0","46","162","101","0"
"Luminary.cfg","205","0","45","160","101","0"
"07a_Settling_Disputes.cfg","2966","0","615","2351","1446","0"
"sk_SK.cfg","17","0","5","12","8","0"
"20_North_Knalga.cfg","2655","0","536","2119","1380","0"
"4p_Castle_Hopping_Isle.cfg","188","0","44","144","91","0"
"Slurbow.cfg","474","0","105","369","232","0"
"16_The_Kalian.cfg","1709","0","381","1328","796","0"
"slider_default.cfg","424","0","95","329","181","0"
"Mystic.cfg","458","0","95","363","234","0"
"4p_Underworld.cfg","188","0","44","144","91","0"
"13_The_Drowned_Plains.cfg","1282","0","274","1008","616","0"
"Autumn_Shyde.cfg","98","0","22","76","56","0"
"07_Meeting_of_the_Minds.cfg","813","0","179","634","391","0"
"Ruffian.cfg","33","0","8","25","17","0"
"Giant_Rat.cfg","182","0","41","141","91","0"
"Horse_Knight.cfg","524","0","110","414","261","0"
"language.cfg","6","0","2","4","3","0"
"03_Toward_Mountains_of_Haag.cfg","1393","0","308","1085","666","0"
"14_Shadows.cfg","1408","0","267","1141","753","0"
"cart-utils.cfg","1847","0","335","1512","1002","0"
"test_lua_mapgen.cfg","61","0","18","43","25","0"
"loadscreen.cfg","328","0","80","248","139","0"
"Loyalist_Lieutenant.cfg","348","0","77","271","166","0"
"de_DE.cfg","24","0","6","18","13","0"
"02_hotkeys.cfg","788","0","194","594","342","0"
"7_Outriding_the_Outriders.cfg","1948","0","426","1522","929","0"
"cs_CZ.cfg","21","0","6","15","10","0"
"test_clear.cfg","46","0","7","39","28","0"
"eo_XX.cfg","17","0","5","12","8","0"
"multi_page_default.cfg","70","0","18","52","30","0"
"schema.cfg","256","0","37","219","168","6"
"Dark_Assassin3.cfg","48","0","12","36","22","0"
"overlay.cfg","6552","0","1177","5375","3200","0"
"04_The_Bay_of_Pearls.cfg","2806","0","632","2174","1288","0"
"Inferno.cfg","283","0","55","228","156","0"
"he_IL.cfg","25","0","7","18","12","0"
"village.cfg","6552","0","1177","5375","3200","0"
"0002-poisoning.cfg","462","0","114","348","208","0"
"12_Terror_at_the_Ford_of_Parthyn.cfg","3675","0","791","2884","1755","0"
"Corrupted_Elf.cfg","386","0","72","314","220","0"
"utils.cfg","714","0","157","557","337","0"
"Ancient.cfg","198","0","44","154","97","0"
"guardians.cfg","2055","0","441","1614","1021","0"
"lan_server.cfg","0","0","0","0","0","0"
"types.cfg","199","0","35","164","99","0"
"08_Council_of_Hard_Choices.cfg","574","0","121","453","286","0"
"spacer_default.cfg","18","0","5","13","8","0"
"vertical_scrollbar.cfg","188","0","51","137","68","0"
"Blademaster.cfg","278","0","54","224","153","0"
"cutscene.cfg","249","0","60","189","119","0"
"eras.cfg","335","0","62","273","178","0"
"prestart_settings.cfg","467","0","24","443","398","0"
"scenario-story.cfg","105","0","24","81","52","0"
"ko_KR.cfg","21","0","6","15","10","0"
"Crossbowman.cfg","483","0","101","382","252","0"
"08b_The_Tides_of_War.cfg","2936","0","530","2406","1610","0"
"High_Lord.cfg","373","0","82","291","181","0"
"Giant_Spider.cfg","294","0","66","228","141","0"
"single.cfg","490","0","87","403","239","0"
"Mounted_Fighter.cfg","276","0","59","217","142","0"
"Sentinel.cfg","417","0","92","325","203","0"
"Dwarvish_Masked_Sentinel.cfg","363","0","82","281","173","0"
"borders.cfg","1107","0","231","876","576","0"
"Enchantress.cfg","321","0","70","251","161","0"
"Ghoul.cfg","32","0","8","24","16","0"
"04_Unlawful_Orders.cfg","2185","0","476","1709","1102","0"
"swarm_disables_upgrades.cfg","414","0","7","407","396","0"
"9_Caverns_of_Flame.cfg","2596","0","594","2002","1164","0"
"08_Talking_to_Tyegea.cfg","833","0","190","643","392","0"
"Loyalist_Pikeman.cfg","427","0","96","331","196","0"
"01_Invasion.cfg","1802","0","400","1402","836","0"
"ANL_worker_options.cfg","1791","0","352","1439","892","0"
"12_Revenge.cfg","3186","0","671","2515","1557","0"
"Infantry_Commander.cfg","286","0","63","223","137","0"
"23_Test_of_the_Clans.cfg","1669","0","369","1300","781","0"
"Horseman_Commander.cfg","420","0","79","341","233","0"
"Sharpshooter.cfg","450","0","100","350","211","0"
"mp_method_selection.cfg","715","0","175","540","303","0"
"08_Carcyn.cfg","1291","0","282","1009","612","0"
"ANL_special_macros.cfg","1100","0","260","840","454","0"
"Rouser.cfg","476","0","87","389","287","0"
"Dwarvish_Masked_Berserker.cfg","391","0","64","327","242","0"
"22_Return_to_Wesnoth.cfg","1154","0","243","911","559","0"
"Kalian_map.cfg","972","0","228","744","475","0"
"fr_FR.cfg","17","0","5","12","8","0"
"test_move.cfg","286","0","58","228","151","0"
"hotkeys.cfg","1549","0","391","1158","630","0"
"06_Swamps_of_Illuven.cfg","734","0","159","575","344","0"
"Cataphract.cfg","392","0","83","309","202","0"
"Dark_Assassin2.cfg","48","0","12","36","22","0"
"17a_The_Duel.cfg","886","0","192","694","430","0"
"02_The_Human_Army.cfg","1006","0","222","784","469","0"
"bottleneck_defense.cfg","656","0","142","514","327","0"
"custom_options_tree.cfg","575","0","145","430","237","0"
"05_The_Oldwood.cfg","1760","0","313","1447","1010","0"
"2p_Hellhole.cfg","326","0","48","278","206","0"
"team-colors.cfg","19","0","5","14","10","0"
"06_Two_Paths.cfg","741","0","156","585","360","0"
"Fire_Guardian.cfg","386","0","70","316","224","0"
"scrollbar_panel_default.cfg","98","0","25","73","33","0"
"12_Revelations.cfg","1617","0","278","1339","949","0"
"Loyalist_Duelist.cfg","318","0","71","247","153","0"
"02_Blackwater_Port.cfg","1821","0","417","1404","846","0"
"grc_GR.cfg","21","0","6","15","10","0"
"move_skip_sighted.cfg","291","0","60","231","149","0"
"Paragon.cfg","271","0","58","213","136","0"
"11_Southbay_in_Winter.cfg","794","0","163","631","418","0"
"05_Epilogue.cfg","167","0","38","129","80","0"
"17_Breaking_the_Siege.cfg","1541","0","325","1216","770","0"
"editor_edit_side.cfg","1113","0","268","845","486","0"
"01_The_Hunt.cfg","1506","0","314","1192","743","0"
"progress_bar_default.cfg","136","0","35","101","59","0"
"3t_The_Council_Regathers.cfg","858","0","193","665","402","0"
"03_To_the_Mines.cfg","544","0","119","425","254","0"
"Pirate_Galleon.cfg","138","0","33","105","68","0"
"02_The_Raid.cfg","713","0","154","559","346","0"
"09a_Elf_Epilogue.cfg","106","0","25","81","52","0"
"nb_NO.cfg","17","0","5","12","8","0"
"lua_interpreter.cfg","364","0","90","274","156","0"
"unit_create.cfg","698","0","173","525","293","0"
"Outlaw_Bandit.cfg","203","0","41","162","111","0"
"gd_GB.cfg","17","0","5","12","8","0"
"advanced_preferences.cfg","537","0","127","410","262","0"
"2p_Hamlets.cfg","128","0","30","98","62","0"
"03_The_Contention.cfg","1059","0","230","829","504","0"
"6p_Crusaders_Field.cfg","272","0","63","209","133","0"
"label_default.cfg","401","0","82","319","201","0"
"Herbalist.cfg","203","0","44","159","102","0"
"khalifate-default.cfg","7","0","2","5","4","0"
"ga_IE.cfg","17","0","5","12","8","0"
"tooltip_large.cfg","82","0","21","61","34","0"
"Noble_Lord.cfg","346","0","74","272","172","0"
"network_transmission.cfg","235","0","59","176","97","0"
"Entangler.cfg","308","0","64","244","161","0"
"Sylph.cfg","459","0","98","361","238","0"
"test_lua_wml.cfg","92","0","17","75","47","0"
"15_The_Lost_General.cfg","2259","0","497","1762","1068","0"
"Junior_Commander.cfg","274","0","53","221","151","0"
"Dragonguard.cfg","701","0","147","554","347","0"
"wesnoth-manual.cfg","150","0","15","135","118","16"
"trash.cfg","800","0","208","592","297","0"
"Flare.cfg","292","0","56","236","161","0"
"theme_list.cfg","377","0","94","283","159","0"
"tracks.cfg","944","0","128","816","565","0"
"Scout.cfg","452","0","89","363","240","0"
"14_Entering_the_Northlands.cfg","848","0","184","664","403","0"
"04_High_Pass.cfg","875","0","190","685","412","0"
"20a_North_Elves.cfg","3415","0","600","2815","1950","0"
"af_ZA.cfg","17","0","5","12","8","0"
"formula_ai_poisoning.cfg","129","0","31","98","53","0"
"Child_King.cfg","116","0","26","90","63","0"
"Bone_Captain.cfg","186","0","39","147","99","0"
"deprecated-utils.cfg","879","0","216","663","328","9"
"toggle_button_orb.cfg","337","0","81","256","129","0"
"Ethereal_Ghost.cfg","68","0","17","51","28","0"
"about.cfg","5194","0","1296","3898","2124","0"
"Dwarvish_Loremaster.cfg","406","0","83","323","216","0"
"Bat_Dread.cfg","45","0","11","34","21","0"
"10_Epilogue.cfg","779","0","147","632","424","0"
"Loyalist_Dragoon.cfg","358","0","81","277","171","0"
"Skeleton.cfg","257","0","59","198","118","0"
"Mage_Elder.cfg","313","0","69","244","150","0"
"Raider.cfg","294","0","63","231","152","0"
"09_Bounty_Hunters.cfg","1684","0","336","1348","873","0"
"Loyalist_Master_at_Arms.cfg","554","0","129","425","243","0"
"17c_Troll_Hole.cfg","1354","0","249","1105","740","0"
"02_Reclaiming_the_Past.cfg","707","0","156","551","333","0"
"dehydration-utils.cfg","751","0","153","598","406","0"
"stage.cfg","218","0","49","169","94","0"
"Dark_Assassin1.cfg","327","0","69","258","167","0"
"transient_message.cfg","178","0","45","133","74","0"
"depcheck_confirm_change.cfg","330","0","82","248","143","0"
"image-utils.cfg","994","0","237","757","427","0"
"Loyalist_Cavalryman.cfg","260","0","60","200","122","0"
"Dwarvish_Annalist.cfg","395","0","80","315","214","0"
"01_The_Uprooting.cfg","1947","0","400","1547","976","0"
"Skele_Death_Knight.cfg","459","0","84","375","264","0"
"units.cfg","596","0","150","446","276","0"
"khalifate-aoh.cfg","7","0","2","5","4","0"
"test_end_turn.cfg","39","0","3","36","33","0"
"Wose.cfg","270","0","62","208","124","0"
"small_resolution.cfg","776","0","193","583","304","0"
"groups.cfg","81","0","18","63","38","0"
"surrender_quit.cfg","283","0","70","213","124","0"
"Soldier_King.cfg","142","0","32","110","73","0"
"Skeletal_Dragon.cfg","277","0","62","215","135","0"
"transitions.cfg","5854","0","1068","4786","2824","0"
"Loyalist_General.cfg","469","0","93","376","252","0"
"core_dialog.cfg","517","0","129","388","218","0"
"B3.cfg","0","0","0","0","0","0"
"ai.cfg","1643","0","386","1257","666","24"
"Firetrooper.cfg","685","0","156","529","328","0"
"05_Blackwater.cfg","1238","0","291","947","547","0"
"ai_candidate_actions.cfg","503","0","127","376","214","0"
"misc.cfg","670","0","161","509","280","0"
"filler.cfg","62","0","15","47","26","0"
"dev_multiplayer.cfg","11","0","2","9","8","0"
"idle_ai.cfg","27","0","7","20","13","0"
"Dwarvish_Masked_Guardsman.cfg","337","0","75","262","163","0"
"19_Costly_Revenge.cfg","1414","0","312","1102","664","0"
"fast.cfg","235","0","47","188","131","0"
"02_Across_the_Harsh_Sands.cfg","5256","0","1114","4142","2521","0"
"11a_The_Eastern_Flank.cfg","1647","0","363","1284","780","0"
"12_Walking_Trees.cfg","1101","0","250","851","502","0"
"matrix_default.cfg","352","0","87","265","124","0"
"vi_VN.cfg","17","0","5","12","8","0"
"toggle_button_default.cfg","376","0","87","289","143","0"
"ro_RO.cfg","17","0","5","12","8","0"
"04_The_Spiral_Path.cfg","764","0","165","599","355","0"
"preferences.cfg","971","0","242","729","387","0"
"ja_JP.cfg","21","0","6","15","10","0"
"Haunt.cfg","76","0","20","56","28","0"
"21_Against_the_World.cfg","694","0","144","550","349","6"
"mp_staging.cfg","1878","0","443","1435","835","0"
"09_Fallen_Lich_Point.cfg","2132","0","441","1691","1080","0"
"horizontal_scrollbar.cfg","172","0","47","125","64","0"
"install_dependencies.cfg","253","0","63","190","107","0"
"test_lua_wml_tagnames.cfg","18","0","2","16","15","0"
"Sea_Serpent.cfg","177","0","39","138","91","0"
"04_Clearing_the_Mines.cfg","2020","0","399","1621","1016","0"
"Loyalist_Royal_Guard.cfg","306","0","56","250","178","0"
"help_browser.cfg","389","0","97","292","157","0"
"Apothecary.cfg","206","0","45","161","103","0"
"05_Choice_In_The_Fog.cfg","3413","0","755","2658","1594","0"
"Spirit_Wraith.cfg","549","0","84","465","355","0"
"default.cfg","2372","0","544","1828","1134","0"
"03_Kalian_under_Attack.cfg","3926","0","735","3191","2098","0"
"16_Weldyn_under_Attack.cfg","1140","0","257","883","516","0"
"Initiate.cfg","322","0","70","252","162","0"
"Lich_Lord.cfg","680","0","147","533","345","0"
"dm-macros.cfg","57","0","9","48","40","0"
"sound_sources.cfg","159","0","35","124","86","0"
"06a_Into_the_Depths.cfg","2909","0","623","2286","1401","0"
"unit_preview_pane.cfg","1127","0","280","847","470","0"
"unit_spawns_at_nearest_vacant_hex.cfg","138","0","13","125","102","0"
"15_A_New_Land.cfg","1877","0","365","1512","1007","3"
"wml_message.cfg","1667","0","347","1320","837","9"
"game_version.cfg","1466","0","357","1109","613","0"
"Pathfinder.cfg","366","0","69","297","207","0"
"test_create_side.cfg","243","0","49","194","128","0"
"12_Evacuation.cfg","1234","0","271","963","579","0"
"08_Alone_at_Last.cfg","3438","0","700","2738","1728","0"
"recruit_facing.cfg","856","0","107","749","566","0"
"message.cfg","332","0","83","249","137","0"
"wolves.cfg","891","0","181","710","469","0"
"game_load.cfg","1317","0","319","998","566","0"
"en_GB.cfg","30","0","6","24","19","0"
"2p5_Reaching_the_Runecrafter.cfg","1142","0","251","891","542","0"
"6p_The_Manzivan_Traps.cfg","284","0","68","216","135","0"
"Familiar.cfg","321","0","68","253","167","0"
"08_Clearwater_Port.cfg","3279","0","656","2623","1710","0"
"it_IT.cfg","17","0","5","12","8","0"
"Wild_Wyvern.cfg","164","0","36","128","85","0"
"scenario-utils.cfg","161","0","40","121","69","0"
"Fire_Dragon.cfg","468","0","99","369","238","0"
"4p_Clash.cfg","188","0","44","144","91","0"
"objective-utils.cfg","34","0","9","25","16","6"
"logging.cfg","529","0","130","399","215","0"
"Falcon.cfg","256","0","57","199","123","0"
"05a_02_Dealings.cfg","645","0","138","507","313","0"
"Horse_Grand_Knight.cfg","333","0","75","258","157","0"
"panel_wml_message.cfg","138","0","34","104","57","0"
"16_The_Mage.cfg","1511","0","340","1171","687","0"
"B2.cfg","0","0","0","0","0","0"
"basic.cfg","101","0","16","85","72","3"
"scroll_label_description.cfg","279","0","65","214","116","0"
"internal-complex.cfg","869","0","182","687","338","0"
"default_config.cfg","361","0","80","281","162","0"
"gamestate_inspector.cfg","1068","0","155","913","704","0"
"pathfind_1.cfg","0","0","0","0","0","0"
"14_Plunging_Into_the_Darkness.cfg","2158","0","498","1660","988","0"
"campaign_dialog.cfg","955","0","237","718","401","0"
"el_GR.cfg","21","0","6","15","10","0"
"nl_NL.cfg","17","0","5","12","8","0"
"modifications.cfg","956","0","192","764","431","0"
"panel_story_viewer.cfg","168","0","41","127","71","0"
"interface-utils.cfg","902","0","207","695","354","3"
"Siren.cfg","334","0","73","261","165","0"
"screenshot_notification.cfg","482","0","118","364","209","0"
"pl_PL.cfg","17","0","5","12","8","0"
"13_The_Dwarvish_Stand.cfg","954","0","209","745","444","0"
"2p_Elensefar_Courtyard.cfg","592","0","94","498","360","0"
"Woodsman_Poacher.cfg","316","0","69","247","157","0"
"ANL_research_options.cfg","948","0","170","778","533","0"
"multimenu_button_default.cfg","504","0","113","391","221","0"
"sr_RS.cfg","21","0","6","15","10","0"
"05_Schism.cfg","1361","0","279","1082","686","0"
"Sea_Orc.cfg","272","0","52","220","153","0"
"24_Battle_for_Wesnoth.cfg","1708","0","368","1340","820","0"
"Necrophage.cfg","32","0","8","24","16","0"
"Caravan.cfg","95","0","21","74","50","0"
"unit_recall.cfg","1156","0","287","869","491","0"
"scatter_units.cfg","52","0","4","48","43","0"
"Loyalist_Fencer.cfg","350","0","64","286","199","0"
"12_Confrontation.cfg","1144","0","248","896","541","0"
"Citizen.cfg","186","0","37","149","110","0"
"Necro_Dark_Adept.cfg","35","0","8","27","19","0"
"Outlaw.cfg","413","0","94","319","189","0"
"Ethereal_Wraith.cfg","60","0","15","45","25","0"
"06b_Slave_of_the_Undead.cfg","1158","0","233","925","605","0"
"Corpse_Ghast.cfg","192","0","43","149","92","0"
"3_Searching_for_the_Runecrafter.cfg","1864","0","428","1436","821","0"
"rebels-default.cfg","79","0","13","66","53","0"
"Scorcher.cfg","514","0","113","401","253","0"
"cutscene-minimal.cfg","138","0","35","103","61","0"
"19_The_Vanguard.cfg","2280","0","421","1859","1270","0"
"08a_Vengeance.cfg","2179","0","387","1792","1257","0"
"Arbiter.cfg","604","0","120","484","321","0"
"formula_ai.cfg","111","0","25","86","49","0"
"Darawf.cfg","166","0","36","130","90","0"
"4p_Hamlets.cfg","204","0","48","156","99","0"
"13_News_from_the_Front.cfg","759","0","184","575","323","0"
"4p_Isars_Cross.cfg","202","0","48","154","97","0"
"game_save_oos.cfg","448","0","111","337","193","0"
"Outlaw_Fugitive.cfg","417","0","94","323","192","0"
"Loyalist_Halberdier.cfg","552","0","123","429","258","0"
"Injured_Sergeant.cfg","44","0","11","33","21","0"
"Thrasher.cfg","567","0","92","475","353","0"
"Great.cfg","202","0","44","158","101","0"
"Alien_Minion.cfg","341","0","69","272","195","0"
"english.cfg","184","0","38","146","107","0"
"Ethereal_Spectre.cfg","56","0","14","42","23","0"
"northerners-aoh.cfg","78","0","13","65","52","0"
"Epilogue.cfg","868","0","187","681","429","0"
"07c_A_Small_Favor3.cfg","4382","0","867","3515","2200","0"
"04_The_Siege_of_Barag_Gor.cfg","2135","0","441","1694","1073","0"
"_final.cfg","0","0","0","0","0","0"
"toggle_button_listbox_header.cfg","577","0","137","440","231","0"
"Mage_Red.cfg","493","0","114","379","219","0"
"label_title_screen_tip.cfg","219","0","55","164","90","0"
"Quintain.cfg","193","0","40","153","102","0"
"B1.cfg","0","0","0","0","0","0"
"Infantry_Lieutenant.cfg","195","0","44","151","93","0"
"04_sound.cfg","413","0","91","322","186","0"
"3p_Alirok_Marsh.cfg","151","0","35","116","74","0"
"04a_The_Swamp_of_Esten.cfg","2258","0","432","1826","1195","0"
"Dust_Devil.cfg","535","0","121","414","257","0"
"Spirit_Ghost.cfg","752","0","124","628","462","0"
"10_Heart_Mountains.cfg","818","0","176","642","392","0"
"es_ES.cfg","39","0","6","33","28","0"
"5p_The_Wilderlands.cfg","1089","0","205","884","575","0"
